ALCAPONE: molho, presunto mussarela, calabresa, cebola, creme de leite, manjericão e orégano ATRAÇÃO: molho, presunto, mussarela, cheddar. Creme de leite e orégano

ATUM: molho, mussarela, atum e orégano

BACON: molho, mussarela, tomate, bacon e orégano BACON ESPECIAL: molho, mussarela, tomate, bacon, milho, ovo e orégano

BAIANA: molho, mussarela, mistura de calabresa com cebola picada e pimenta e orégano

BOLONHESA: molho, mussarela, carne moída, cebola e orégano. CALABRESA: molho, mussarela, calabresa e orégano.

DELICIOSA: molho, frango, mussarela, palmito e orégano

DOM CAMILO: molho, presunto, mussarela, calabresa, creme de leite e orégano

FRANCESA: molho, lombo, mussarela, gema de ovo, creme de leite e orégano

FRANGO: molho, frango, mussarela e orégano

FRANGO ESPECIAL: molho, frango, mussarela, milho e orégano FRANGO AO CAUPIRY: molho, frango, catupiry e orégano

FRICASSÉ DE CALABRESA: molho, mussarela, calabresa, creme de leite, catupiry, milho,

orégano e batata

GOIANA: molho, mussarela, frango desfiado, gueiroba e orégano LOMBO CANADENSE: molho, mussarela, lombo e orégano

MARGUERITA: molho, mussarela, queijo parmesão, tomate, manjericão e orégano

MEDALHÃO: molho, frango, mussarela, bacon e orégano

MUSSARELA: molho, mussarela, tomate e orégano

NAPOLITANA: molho, mussarela, tomate, palmito e orégano NORDESTINA: molho, carne de sol desfiada, mussarela, cebola e orégano

NORDESTINA AO BARBECUE: molho, carne de sol desfiada, mussarela, molho barbecue e

orégano NORDESTINA AO CATUPIRY: molho, carne de sol desfiada, catupiry e orégano

PALMITO: molho, mussarela, palmito e orégano

PAPA: molho, presunto, mussarela, calabresa, milho, bacon, cebola e orégano

PIPOTY: molho, frango, mussarela, milho, creme de leite e orégano PORTUGUESA: molho, presunto, mussarela, calabresa, cebola, ovo e orégano PORTUGUESA ESPECIAL: molho, presunto, mussarela, calabresa, milho, cebola, ovo e orégano

PRESUNTO: molho, presunto, mussarela ralada e orégano QUATRO QUEIJOS: molho, mussarela, provolone, catupiry, cheddar e orégano ROMANA: molho, presunto, mussarela, calabresa, cebola e orégano VEGETARIANA: molho, mussarela, tomate, palmito, milho, ervilha e orégano TOSCANA: molho, mussarela, linguiça, cebola e orégano.

PIZZAS DOCES

BANANA: banana, canela e mussarela

CALIFORNIA: molho, lombo, pêssego, ameixa, uva passas e mussarela

CHOCOLATE: leite condensado, chocolate e castanha

CHOCOLATE COM MORANGO: leite condensado, chocolate, morangos e castanha

HAWAI: molho, lombo, abacaxi e mussarela

ROMEU E JULIETA: goiabada, mussarela e creme de leite

PRESTÍGIO: leite condensado, chocolate, coco e castanha TROPICÁLIA: molho, presunto, pêssego, abacaxi e mussarela

LASANHAS

BOLONHESA: molho à bolonhesa, presunto, mussarela e catupiry. FRANGO: molho de frango, presunto, mussarela e catupiry.