SABOR D' ITÁLIA: MUSSARELA, PRESUNTO, CALABRESA, BACON, CATUPIRY E OREGANO 
A MODA: MUSSARELA, PRESUNTO, CALABRESA, BACON, FRANGO,TOMATE E OREGANO
AMERICANA: MUSSARELA, BACON,OVOS,CEBOLA, AZEITE E OREGANO 
ATUM: MUSSARELA,ATUM E OREGANO
ALHO E ÓLEO: MUSSARELA,ALHO,ÓLEO E OREGANO 
BACON: MUSSARELA, BACON E OREGANO
BIANCO: MUSSARELA, MOLHO DE TOMATE, BACON, CHAMPIGNON,PALMITO E OREGANO
BAIANA: MUSSARELA, CALABRESA, PIMENTA, CEBOLAQ, PRESUNTO E OREGANO
CAIPIRA: MUSSARELA, FRANGO,OVOS, MILHO E OREGANO
CALABRESA: MUSSARELA, CALABRESA, CEBOLA E OREGANO
CALZONE: MUSSARELA, TOMATE, CATUPIRY,PRESUNTO E OREGANO
CHAMPINGNON: MUSSARELA, CHAMPIGNON, FRANGO, CREME DE LEITE E OREGANO
DISTRITAL: MUSSARELA, PRESUNTO, BACON,SALAMINHO, OVOS E OREGANO 
FRANGO-CATUPIRY: MUSSARELA, FRANGO,CATUPIRY E OREGANO
GOIANA: MUSSARELA, FRANGO,MILHO, PALMITO,AZEITONA E OREGANO
GOIANIRA: MUSSARELA, PRESUNTO, CALABRESA, PIMENTÃO E OREGANO
GREEK: MUSSARELA, PEPERONE, SALAMINHO, PIMENTÃO, AZEITONA E OREGANO
HAVAIANA: MUSSARELA, LOMBO,PALMITO, AZEITONA E OREGANO
ITALIANA: MUSSARELA, LOMBO, FRANGO,CATUPIRY E OREGANO
LOMBO: MUSSARELA, LOMBO,CATUPIRY E OREGANO
LITTLE ITALY: MUSSARELA, LOMBO,CATUPIRY,CHAMPIGNOM E OREGANO
MONTANA: MUSSARELA, SALAMINHO, CEBOLA, PIMENTÃO,ABACAXI E OREGANO
MARGUERITA: MUSSARELA, MANJERICÃO FRESCO, TOMATE E OREGANO
MUSSARELA: MUSSARELA, TOMATE E OREGANO
NAPOLITANA: MUSSARELA, PRESUNTO, TOMATE, CEBOLA E OREGANO
PINNA: MUSSARELA, PRESUNTO, BACON, PIMENTÃO,ABACAXI E OREGANO
PORTUGUESA: MUSSARELA, PRESUNTO, CALABRESA, CEBOLA, PIMENTÃO,OVO,AZEITONA E OREGANO
PAULISTA: MUSSARELA, PALMITO,ATUM SÓLIDO,MOLHO DE TOMATE E OREGANO
PALMITO: MUSSARELA, PALMITO E OREGANO
PRESUNTO: MUSSARELA, PRESUNTO E OREGANO
PEPERONE-CHAMPINGNON: MUSSARELA, PEPERONE, CHAMPIGNON E OREGANO
RED EYE: MUSSARELA, PRESSUNTO, PEPERONE, CEBOLA, PIMENTA CALABRESA E OREGANO MUSSARELA, FRANGO,AZEITONA, PALMITO, CHAMINGNON E OREGANO
ROMANA: MUSSARELA, BACON, MILHO VERDE, CHAMPIGNON E OREGANO
SICILIANA: MUSSARELA, BACON,MILHO VERDE, PRESUNTO E OREGANO
TROPICAL VEGETARIANA: MUSSARELA, PALMITO,TOMATE, PIMENTÃO, AZEITONA, CEBOLA E OREGANO 
4 QUEIJOS: MUSSARELA, PROVOLONE,CATU PIRY, PARMESÃO E OREGANO
CALIFORNIA: MUSSARELA, PRESUNTO,PÊSSEGO,FIGO E ABACAXI
CHOCOLATE: MUSSARELA, CHOCOLATE E CREME DE LEITE
BANANA COM CANELA: MUSSARELA, BANANA E CANELA
