Pizzas Salgadas / Pizzas Doces / Calzones / Bordas Recheadas Batata Frita / Omelete / Sucos / Cremes / Refrigerantes / Cerveja

À MODA: MOLHO, MUSSARELA, APRESUNTADO, OVO, CEBOLA, CATUPIRY, AZEITONA E OREGANO

MINEIRINHA: MOLHO, MUSSARELA, LOMBO CANADENSE, QUELIO MINAS, TOMATE SECO, RUCULA, AZEITONA E OREGANO

MUSSARELA: MOLHO, MUSSARELA, TOMATE, AZEITONA

E OREGANO

Talentos

ALHO: MOLHO, MUSSARELA, ALHO, AZEITE, TOMATE, AZEITONA

E OREGANO

ATUM: MOLHO, MUSSARELA, ATUM, TOMATE, CEBOLA, AZEITONA E OREGANO

NAPOLITANA: MOLHO, MUSSARELA, PALMITO, TOMATE, CEBOLA, AZEITONA E OREGANO

BACON: MOLHO, MUSSARELA, BACON, TOMATE, AZEITONA E OREGANO

PAULISTA: MOLHO, MUSSARELA, CALABRESA, ERVILHA, AZEITONA, OREGANO E BATATA PALHA

BAIANA: MOLHO, MUSSARELA, CALABRESA PICADA, PIMENTA CALABRESA, AZEITONA E OREGANO

PALMITO: MOLHO, MUSSARELA, PALIMITO, AZEITONA E OREGANO

Forno & Tenha PIZZARIA

BRASILEIRA: MOLHO, MUSSARELA, LOMBO CANADENSE, BACON, TOMATE, CEBOLA, AZEITONA E OREGANO

PEPPERONY: MOLHO, MUSSARELA, PEPPERONI, CEBOLA, AZEITONA E OREGANO

CALABRESA: MOLHO, MUSSARELA, CALABRESA, CEBOLA, AZEITONA E OREGANO

PORTUGUESA: MOLHO, MUSSARELA, APRESUNTADO, OVO, CEBOLA, PALMITO, ERVILHA, AZEITONA E OREGANO

CALABRESA ESPECIAL: MOLHO, MUSSARELA, CALABRESA, TOMATE, CEBOLA, AZEITONA, OREGANO E BATATA PALHA

PRESUNTO: MOLHO, MUSSARELA, APRESUNTADO, TOMATE, AZEITONA E OREGANO

Tele entregas:

Aceitamos Cartões:

VISA

CARNE DE SOL: MOLHO, MUSSARELA, CARNE SECA DESFIADA, CATUPIRY, TOMATE, CEBOLA, AZEITONA E OREGANO

QUATRO QUEIJOS: MOLHO, MUSSARELA, PROVOLONE, PARMESÃO, CATUPIRY, AZEITONA E OREGANO

ESPONHOLA: MOLHO, MUSSARELA, CALABRESA, BACON, CATUPIRY, AZEITONA E OREGANO

ROMA: MOLHO, MUSSARELA, PEITO DE PERU, ERVILHA CATUPIRY, PROVOLONE, RÚCULO, AZEITONA E OREGANO

ESTROGONOFE DE CARNE: MOLHO, MUSSARELA, ESTROGONOFE DE CARNE, CATUPIRY, AZEITONA, OREGANO E BATATA PALHA

SUPREMA: MOLHO, MUSSARELA, APRESUNTADO, BACON, LOMBO CANADENSE, MILHO CATUPIRY, ERVILHA, AZEITONA E OREGANO

ESTROGONOFE DE FRANGO: MOLHO, MUSSARELA, ESTROGONOFE DE FRANGO, CATUPIRY, AZELTONA, OREGANO E BATATA PALHA

TALENTOS: MOLHO, MUSSARELA, PEITO DE PERU PICADO, CATUPIRY, TOMATE, PALMITO, AZEITONA E OREGANO

FRANCESA: MOLHO, MUSSARELA, OVO, LOMBO CANADENSE, CREME DE LEITE, AZEITONA E OREGANO

TOMATE SECO: MOLHO, MUSSARELA, TOMATE SECO, RÚCULA, AZEITONA E OREGANO

MasterCard

62 3517-4454 62 99326-0034

elo

FRANGO COM CHEDDAR: MOLHO, MUSSARELA, FRANGO DESFIADO, TOMATE, CHEDDAR, AZEITONA E OREGANO

VEGETARIANA: MOLHO, MUSSARELA, TOMATE, PIMENTÃO, PALMITO, CEBOLA, MILHO, ERVILHA, AZEITONA E OREGANO

FRANGO COM BACON: MOLHO, MUSSARELA, FRANGO DESFIADO, BACON, MILHO, AZEITONA E OREGANO

VULCÃO: MOLHO, MUSSARELA, FRANGO COM CATUPIRY CALABRESA, AZITONA OREGANO, COM BORDA RECHEADA DE CALABRESA PICADA, APRESUNTADO PICADO E CATUPIRY

FRANGO COM CATUPIRY: MOLHO, MUSSARELA, FRANGO DESFIADO, CATUPIRY, AZEITONA E OREGANO

BANANA

MUSSARELA, BANANA, AÇÚCAR E CANELA

FRANGO ESPECIAL: MOLHO, MUSSARELA, CALABRESA, FRANGO, BACON, MILHO, AZEITONA E OREGANO

BANANA COM CHOCOLATE MUSSARELA, BANANA E CHOCOLATE

GAIVOTA: MOLHO, MUSSARELA, FRANGO DESFIADO, MILHO, ERVILHA, BACON, AZEITONA E OREGANO

CHOCOLATE

MUSSARELA E CHOCOLATE

GAÚCHA: MOLHO, MUSSARELA, PURE DE MANDIOCA OU MANDIOCA CHOCOLATE BRANCO COZIDA PICADA, COSTELA BOVINA DESFIADA, CEBOLA, AZEITONA E OREGANO

MUSSARELA, CHOCOLATE BRANCO COM RASPA DE LIMÃO

IMPERIAL: MOLHO, MUSSARELA, CALABRESA, APRESUNTADO, BACON, FRANGO DESFIADO, TOMATE, ERVILHA, MILHO, PALMITO, PIMENTÃO, AZEITONA E OREGANO

CALIFORNIA

MUSSARELA, PEITO DE PERU, PESSEGO, FIGO, ABACAXI E AMEIXA

LOMBINHO: MOLHO, MUSSARELA, LOMBO CANADENSE, CATUPIRY, AZEITONA E OREGANO

PRESTIGIO

MUSSARELA, CHOCOLATE E COCO RALADO

LIDERANÇA: MOLHO, MUSSARELA, CARNE SECA DESFIADA, TOMATE, ROMEU E JULIETA

PIMENTÃO, CEBOLA, MOLHO BARBECUE, AZEITONA E OREGANO

MUSSARELA E GOIABADA

MARGUERITA: MOLHO, MUSSARELA, MANJERICÃO, TOMATE, PARMESÃO, AZEITONA E OREGANO