Caipira - muçarela, frango, ovo milho e orégano Calabresa - muçarela, calabresa, cebola e orégano

Distrital - muçarela, presunto, salaminho, bacon, ovo e orégano

Du Chef - muçarela, lombo, palmito, creme de leite e orégano

Du Pai - muçarela, frango, milho, calabresa, bacon, ovo, pimenta calabresa e orégano

Estrogonofe (frango ou carne seca) - muçarela, creme de leite, batata palha e orégano

Frango com Catupiry - muçarela, frango, catupiry e orégano

Goiabeira - muçarela, catupiry, lombo, palmito, creme de leite, bacon e orégano

Goiana - muçarela, frango, palmito, milho, azeitona e orégano

Havaiana - muçarela, lombo, palmito, azeitona e orégano

Honolulu - muçarela, presunto, abacaxi, bacon, pimenta calabresa e orégano

Hot Dog - muçarela, salsicha, milho, batata palha e orégano

Italiana - muçarela, lombo, frango, catupiry,

champignon e orégano

Kalapana - muçarela, lombo, cream chease e abacaxi caramelizado com canela

Lombo-mucareta, lombo, catupiry e orégano

Marguerita - muçarela, manjericão, tomate e orégano

Napolitana - muçarela, presunto, tomate, cebola, palmito e orégano

Paulista - muçarela, atum, palmito e orégano

Peito de Peru com Brócolis - muçarela, peito de peru, brócolis, catupiry, cebola, tomate e orégano

Portuguesa - muçarela, presunto, calabresa, cebola, pimentão verde, ovo, cebola, azeitona e orégano 

Primavera - muçarela, palmito, provolone, cebola, alho e

óleo e orégano

Supreme - muçarela, bacon, cheddar, molho barbecue e orégano

Tomate Seco - muçarela, tomate seco e orégano Vegetariana - muçarela, palmito, tomate, pimentão verde, cebola e orégano

Virgulino - muçarela, carne seca, palmito, cebola, azeitona e orégano Zago-muçarela, presunto, catupiry, cebola, ovo, bacon e orégano

Banana com Canela - muçarela, banana e canela

Brigadeiro - muçarela, creme de leite, chocolate ao leite e granulado

Califórnia - muçarela, presunto, pêssego, figo e abacaxi

Caribe - muçarela, banana e chocolate ao leite

Chocolate - muçarela, creme de leite e chocolate ao

leite

Explosão - muçarela, banana, canela, bacon e pimenta calabresa

Nutella - muçarela, chocolate ao leite, creme de leite e Nutella

Prestígio - muçarela, chocolate ao leite, creme de leite e Coco ralado

Ovomaltine - muçarela, chocolate ao leite, creme de leite e Ovomaltine

Romeu e Julieta - muçarela, goiabada e creme de leite

Calabresa - Catupiry - Chocolate - Cheddar - Goiabada Muçarela - Prestígio - Salsicha - Tomate Seco

Sabores

4 Queijos - muçarela, catupiry, provolone, ricota e

orégano

A Moda - muçarela, presunto, calabresa, frango, bacon,

tomate, milho e orégano

Alho e Óleo - muçarela, alho e óleo e orégano Americana - muçarela, bacon, ovo, cebola, azeitona e orégano

Bacon - muçarela, bacon e orégano Bacon e Pepperoni - muçarela, pepperoni, bacon,

champignon, pimentão verde, cebola e orégano

Baiana - muçarela, calabresa, cebola, pimenta calabresa e orégano

Barbebacon - muçarela, bacon, molho barbecue, ovo, tomate, cebola e orégano Brasileira - muçarela, carne seca, ovo, azeitona, cebola e orégano

Boi Ralado - muçarela, carne moída, calabresa, palmito, bacon e orégano